11111111111111111
10000000000000001
10100001001111101
10100001000000101
10100001000000101
10100001000000101
10111111P000CE101
10000001001111101
10000001001000001
10000001001000001
10000001001111101
10000000000000001
10000000000000001
11111111111111111