11111111111111111111111111
10C00111000101000111000C01
1111E000111000111000011111
1P101110000111000000000101
1000000111C0000000C1110001
11110100001110C01110000101
1C110001010001110001110001
100001000001000001000001C1
11111111111111111111111111