11111111111111111111
1P000000001110000001
10111111101110111101
1010010000001CM00101
10100101111110110101
10100101000110010101
10100101011110010101
10100100000000010001
10111111101111111101
10000000010000100001
10111110101111110101
1C000000100000100001
10111111101111111101
101C00000000C0000001
10000000001110000001
10111111101110111101
101C0000100010000001
101M1111101110111101
1000000010001EM00001
11111111111111111111
